******************##
*******************#
**#****************#
**#**********#******
**#**********#******
**#**********#******
**#**********#******
*************#******
*******T*****#******
********************
#####***************
**********T*********
********************
******T******#******
**##*********#******
